1111111111111111111111111111111111
1EC00C000000000000P000000000000001
1010010100110000001001000000010101
1010010010101010001001000000010101
1000000000000000000000000000000001
1111111111111111111111111111111111