1111111111111111111111111111111111
1EC00C0000000000000000000000000001
1010010100110000001001000000010101
1P10010010101010001001000000010101
10000000000000000000000000100000M1
1111111111111111111111111111111111